1111111111111111111111111111111111111111111111111111111111
10000000000000000000000000000000000000000000000000000000P1
1000000000000000000000000000000000C00000000000000000000001
1000000000000000000000000000001C00C00C10000000000000000001
100000000000000000000000000001C000C000C1000000000000000001
10000000000000000000000000001C0000C0000C100000000000000001
1000000000000000000000000001C00000C00000C10000000000000001
10000000000000000000000000001C0000C0000C100000000000000001
100000000000000000000000000001C000C000C1000000000000000001
1000000000000000000000000000001C00C00C10000000000000000001
100000000000000000000000000000010CCC0100000000000000000001
1000000000000000000000000000001C00C00C10000000000000000001
100000000000000000000000000001C000C000C1000000000000000001
10000000000000000000000000001C0000C0000C100000000000000001
1000000000000000000000000001C00000C00000C10000000000000001
10000000000000000000000000001C0000C0000C100000000000000001
100000000000000000000000000001C000C000C1000000000000000001
1000000000000000000000000000001C00C00C10000000000000000001
100000000000000000000000000000010CCC0100000000000000000001
10000000000000000000000000000001C0C0C100000000000000000001
1000000000000000000000000000001C00C00C10000000000000000001
100000000000000000000000000001C000C000C1000000000000000001
10000000000000000000000000001C0000C0000C100000000000000001
1000000000000000000000000001C00000C00000C10000000000000001
10000000000000000000000000001C0000C0000C100000000000000001
100000000000000000000000000001C000C000C1000000000000000001
1000000000000000000000000000001C00C00C10000000000000000001
100000000000000000000000000000010CCC0100000000000000000001
1000000000000000000000000000000010E01000000000000000000001
1000000000000000000000000000000001010000000000000000000001
1000000000000000000000000000000000100000000000000000000001
1111111111111111111111111111111111111111111111111111111111
