11111111111111111111
10000000000110000001
1011000001P100011101
10C1000001110001C101
10010000000000010101
1001000000000001E101
10010000000000010001
11111111111111111111
