11111111111111111111
10000000000110000001
1011000001P100011101
1001000001110001E000
10010000000000010000
11111111111111111111
