11111111111111111111
1CCCCCCCCCC11CCCCCC1
1C11CCCCC1P1CCC111C1
1CC1CCCCC111CCC1ECC1
1CC1CCCCCCCCCCC1CCC1
11111111111111111111
