111111111111111111111111111111111111111111111111111111111111111
10000000000000000000000000000000000000000000000000000000P000001
1000000000000000000000000000000000C0000000000000000000000000001
1000000000000000000000000000001C00C00C1000000000000000000000001
100000000000000000000000000001C000C000C100000000000000000000001
10000000000000000000000000001C0000C0000C10000000000000000000001
1000000000000000000000000001C00000C00000C1000000000000000000001
10000000000000000000000000001C0000C0000C10000000000000000000001
100000000000000000000000000001C000C000C100000000000000000000001
1000000000000000000000000000001C00C00C1000000000000000000000001
100000000000000000000000000000010CCC010000000000000000000000001
1000000000000000000000000000001C00C00C1000000000000000000000001
100000000000000000000000000001C000C000C100000000000000000000001
10000000000000000000000000001C0000C0000C10000000000000000000001
1000000000000000000000000001C00000C00000C1000000000000000000001
10000000000000000000000000001C0000C0000C10000000000000000000001
100000000000000000000000000001C000C000C100000000000000000000001
1000000000000000000000000000001C00C00C1000000000000000000000001
100000000000000000000000000000010CCC010000000000000000000000001
10000000000000000000000000000001C0C0C10000000000000000000000001
1000000000000000000000000000001C00C00C1000000000000000000000001
100000000000000000000000000001C000C000C100000000000000000000001
10000000000000000000000000001C0000C0000C10000000000000000000001
1000000000000000000000000001C00000C00000C1000000000000000000001
10000000000000000000000000001C0000C0000C10000000000000000000001
100000000000000000000000000001C000C000C100000000000000000000001
1000000000000000000000000000001C00C00C1000000000000000000000001
100000000000000000000000000000010CCC010000000000000000000000001
1000000000000000000000000000000010E0100000000000000000000000001
100000000000000000000000000000000101000000000000000000000000001
100000000000000000000000000000000010000000000000000000000000001
111111111111111111111111111111111111111111111111111111111111111
