11111111111111111111
10000000000110000001
1011000001P100011101
1001000001110001E001
100100000000000100011
11111111111111111111
