11111111111111111111
10000000000110000001
1011000001P100011101
1001000001110001E001
10010000000000E10001
11111111111111111111
