11111111111111111111
100000000001C0000001
1011000001P100011101
10C1000001110001E001
10010000000000010001
11111111111111111111
